1111111111111
10010000000C1111
1000011111000001
1P0011E000001111
1111111111111