 1111111111111
110010000000C1
10000111110001
1P0011E0000001
 1111111111111