111 111111111
10010000000C1
1000011111001
1P0011E00 001
1111111111111