1111111111111111111111111111111111
100C00C0000C0000C00C00C1E000000001
1011111111111111111111010C00111101
101CC000000001111C00010111111C0001
1010001111000111100001000000000001
101000111100000C000001111111111111
10000000000000000000000000000000C1
111111100000CC000C0000000001111111
1C000C10000000001110000000010000C1
10C0C01000011100000010000011000001
100C001000011100000000000011C00001
10C0C0100000C000000000000000000001
1C000C1CC000000000P000000000000001
1000001111111100000000000000000C01
101111100000000000C000010000000001
10000C0000000000000000000000000001
1000000000C0000C0000000C0000C00001
1111111111111111111111111111111111