1111111111111111111111111111111111
100C00C0000C0000C00C00C1E000000001
1011111111111111111111010C00111101
101CC000000001111C00010111111C0001
1010001111000111100001000000000001
101000111100000C000001111111111111
1000000000000000000000000000000001
11111110000000000C0000000001000001
1CCCCC1000000000000000000000000001
1CCCCC1000010000000010000000000001
1CCCCC1000000000000000000010000001
1CCCCC100000C000000000000000000001
1CCCCC100000000000P000000000000001
1CCCCC1000000100000000000000000001
101111100000000000C000010000000001
10000C0000000000000000000000000001
1000000000C0000C0000000C0000C00001
1111111111111111111111111111111111