1111111111111111111111111111111111
1E1000010010010C10001C000001000001
101C010100100000101011000101010101
1011110010101010001001011001010101
1P0000000C00C10000100001C0000000C1
1111111111111111111111111111111111